1111111
1P00001
1000001
1000111
1000CC1
1010111
10000E1
1111111
