1111111
1P00001
1000001
1000111
10000C1
1010111
1000E01
1111111
